Number of found musics:132

3LAU — Lean Away (3LAU Mashup) - Fetty Wap vs Daya vs Major Lazer
VANIC Official — Skinny Love (Vanic Remix)
Grant Gruber — HeLLo
TOMSIZE — Tomsize x Twenty One Pilots - Stressed Out
Unlike Pluto — Diplo - Revolution (Unlike Pluto Remix) [feat. Faustix & Imanos and Kai]
spectrum — Hairitage - Out Here
Timothy Rodrigues — Heaven Trap
Savoy — I'm In Need (SAVOY VIP)
3LY — Habits Hear Me (Dash Berlin Dash-Up)[Buy = Free DL]
MandyJirouxMusic — My Forever (Reez Remix)
Samuel Gaona Fernández — Coldplay - Every Teardrop Is A Waterfall (Avicii Tour Remix)
Tommy Heller — Axwell Λ Ingrosso vs. Alesso vs. Deorro - On My Way vs. Destinations vs. Five Hours (Alesso Mashup)
Spinnin' Records — Michael Woods ft. Lauren Dyson - In Your Arms (Pete Tong Rip) [Available July 14]
Fnord — You And I Flume - Galantis
DOPED UP. — The Chainsmokers - Don't Let Me Down Ft. Daya (Doped Up Remix)
Tomsize — The Weeknd - Prisoner (Tomsize Remix)
Bon Matin — Yellow Vs Don't Let Me Down (Original Vs T - Mass Vs Zomboy Vs Illenium)
bakes•studio — Bastille Vs Audien Vs Party Theives - Pompeii - BAKES STUDIO Rework [Short Edit]
hngjng 🥀 — Alan Walker & The Chainsmokers Ft. ROZES - Faded - Roses Mashup
alex f — Zara Larsson - Never Forget You (Price & Takis Remix)
Arman Cekin — Baby Bash - Suga Suga (Arman Cekin & PLS&TY Remix)
Two Friends VIP — Galantis - No Money (Two Friends Remix)
Sam Halabi — Zara Larsson & MNEK - Never Forget You (Sam Halabi Bootleg)
Quinn K — G - Eazy & Bebe Rexha - Me, Myself & I (No Sleep Remix)
VANIC Official — G-Eazy - But A Dream (Vanic Remix)
HyTyd — Down For The Weekend Feat. Pell (MRVLZ Remix)
Thissongissick.com — Hermitude - The Buzz (feat. Mataya & Young Tapz)
Aspire — Route 94 - My Love (T - Mass Remix)
VANIC Official — Vanic X K.Flay - Make Me Fade
Lucian — Black Coast - TRNDSTTR (Lucian Remix) [feat. M. Maggie]
Official Nation YT — All Time Low (BOXINLION Remix)
WeLikeRaving — Tiesto & KSHMR Feat. VASSY - Secrets (Instant Party! Remix)
Neptunica — Maroon 5 - Cold (Neptunica X Calmani & Grey ft. Vitø Remix)
Trap Music — Zedd, Kesha - True Colors (Nolan Van Lith Remix)
Veorra — Strangers
Aidan — Vicetone - United We Dance (Bvrnout Trap Remix)
Hunter Vance — Galantis - You (Psychic Type VIP Remix)
Jaeger — Lights
NGHTMRE — NGHTMRE - No Coming Down (feat. Alex Wiley & Sky Montique)
CHRIS A — Edward Maya - Stereo Love [CHRIS A Remix] * [FREE DOWNLOAD] *
refunemusic — Otto Knows 'Million Voices' - Pete Tong BBC Radio 1 Play (03.02.12)
Protocol Recordings — Bobby Rock ft Cimo Fränkel - New Life (OUT NOW)
Tiger Records — Jochen Simms - You're Not Alone (Manuel De La Mare vs. Will Gold Remix)
k?d — Steve James - Renaissance Ft. Clairity (k?d Remix)
LℤRD — Illenium - It's All On U (LZRD & T-Mass Remix)
SHAUN FRANK — Shaun Frank - Let You Get Away Ft. Ashe (Shoolz & Shaun Frank VIP Remix)
DesiMixez — Roses, Save Dat Money, Lean Away
va trag in tzeapa — Martin Garrix - Now That Ive Found You (Dropwizz Savagez Remix).mp3
MONST4R — AREA21 - Spaceships
khrnnizam.20_remix2018 — Zedd - Beautiful Now (ft. Jon Bellion) (Marshmello Remix)
Seroga Sergey — Drone In Ibiza - Sky
Mutleyy — DJ Snake - Let Me Love You (BOXINLION Cover Remix)
Safe Place — The Chainsmokers - Don't Let Me Down (T-Mass Remix)
Synthetic — Jinco - Tokyo
Drop Kingdom — Martin Garrix - Now That I'Ve Found You (Dropwizz X Savagez Trap Remix)
Tropix Remixes — KSHMR & Felix Snow Ft. Madi - Touch (Tropix & Jake Guercia Remix)
Jethro — Nicky Romero Vs. Desiigner Novell Panda (Dropwizz X Savagez Remix) - Copy
SuperBeats — DubVision - Turn It Around (Gioni Edit)
iTrap Oficial — Psychic Type - You Alone (Mashup)
pausy world — Ship Wrek & Zookeepers - Ark
Travel Playlist — VID 6, SKATING IN SAN DIEGO - Roadtrip 2 | Neptunica - Alive (feat. Matt Defreitas)
Pedro González — Avicii vs Calvin Harris Feat Florence - Superlove vs Sweet Nothing Pedro G *FREE DOWNLOAD**
Adrian Adi — Tiësto & KSHMR Ft. VASSY - Secrets (ARMNHMR & DATHAN Festival Edit)
Lowly. — Not Your Dope - The Fall (feat. Mia Vaile)
Nobu — Illenium - it's all on you
What So Not — Van She - Idea Of Happiness (What So Not Remix) [OUT NOW ON MODULAR]
SAINT WKND — M83 - MIDNIGHT CITY (SAINT WKND REMIX)
Mixmag — Premiere: Hermitude 'Through The Roof' (Kito & Reija Lee remix)
MrSuicideSheep — ODESZA - All We Need (feat. Shy Girls) (Autograf Remix)
Guntrail — Coming Over - Kygo & Dillon Francis feat. James Hersey
ABSENCE — Lana Del Rey - Born To Die (Absence Remix)
Pucky (Bootlegs) — If We Ever Meet Again (Pucky & Casho Bootleg) DL IN DESCRIPTION
T — ride or die
DVNIEL — let it go - DVNIEL X Lindsay Dunn
BKAYE — Janelle Kroll - Sunny Days (BKAYE Remix)
Myles William — CHLØË BLACK - 27 Club (Myles.William Remix)
Ry Hill — Pillowtalk (Ry Hill Rework)
Wonderlust — MRVLZ - Me & U ft. DEANNA
Dancing Astronaut — bordrs - slo-mo
StayLoose |StéLouse| — Bryce Fox - Horns (StayLoose Remix)
Bassthunder Remixes — Tiësto & KSHMR Feat. VASSY - Secrets (Bassthunder Remix)
Steve James — ZHU - Faded (Steve James Remix)
Corey James — Sebjak - We Are (Corey James & Simon Garcés Remode)
Spinnin' Records — Not Your Dope ft. Oly - What You Do To Me [FREE DOWNLOAD]
EDM eagle |Free Repost| — Dropwizz X Afterfab - Underwater
SynCole — A Sky Full Of Stars (Syn Cole Remix) [PREVIEW]
FELIX CARTAL — Felix Cartal - Ready For Love (feat. Chloe Angelides) [Steve James Remix]
Cedric Gervais — Cedric Gervais feat. Coco - Through The Night (Radio Edit)
Victor Niglio — Edward Maya & Vika Jigulina - Stereo Love (Victor Niglio Remix)
Tiësto — Basement Jaxx "Never Say Never" (Tiësto & MOTi Remix)
RefreXx Music — Eiffel 65 - Blue (Psychic Type Remix)
Jonas Rgz — R3HAB & Skytech - Everything (VIP)
Trap Beat 2016 — Snavs & Fabian Mazur - Murda
rahul roy — XE3 X Wild For The Night (Remk Mashup)
Soundstap — Meric - Take Off (ft. Paul Rey)
Melbourne's Filthiest — Cher - Believe (ID Bootleg)
Regions — Flux Pavilion - Pull The Trigger Feat Cammie Robinson (Regions Remix)
Major Lazer [OFFICIAL] — Major Lazer - Be Together (feat. Wild Belle)(Vanic Remix)
iSlodinx Radio — Zara Larsson - Ain't My Fault (TULE Remix)
Khasper — Yeah Yeah Yeahs X A - Trak - Heads Will Roll (Jaydon Lewis Remix)
RoooK3y — Dropout - Hollywood Horror
💀ElectronicWarehouse💀 — Jayceeoh & JayKode - Testament
Flarrow — Isosine - Nonstop Pop 2015 Mashup
Cobra Beatz — Lukas Graham 7 Years [Chillstep Remix]
TRAP GMN — Vanic X Aquilo - Losing You
Synthetic — WiDE AWAKE & Xam Volo - Games
MoonSoundTrap — Rationale - Fuel To The Fire (The White Panda Remix)
Culture Code — Tritonal & Paris Blohm - Colors (Culture Code Remix)
PRFFTT & Svyable — One Republic- If I Lose Myself (PRFFTT & Svyable Remix)
Deep Chills — Bastille - Flaws (Deep Chills Remix)
Chilly Cizz — Flo Rida - Zillionaire (Chilly Cizz Remix)
Visualess. — Lox Chatterbox - Ghosts (Prod. Max Styler)
Noor Omar — Still Young - Midnight (Party Thieves Remix)
JONO TOSCANO BOOTLEGS/EDITS —
Sambury — Stay vs. Keepin' Score - Sambury Mashup
brednbutter — Jo Cohen & King - Born To Be A King
Arman Cekin — Arman Cekin & Veorra - You Don't Know Me
Ship Wrek — Flux Pavilion & Matthew Koma - Emotional (Ship Wrek Remix)
airia — Somebody That I Used to Know (Airia Remix)
Decoy! — Ed Sheeran - Castle on the Hill (Decoy! Remix)
John Graf — Sandcastles (ToWonder x Severo Remix)
Female to Male Vocal — Melanie Martinez - Cake |Male Vocal|
Zed&Em — Untitled 1.2
ßr@in — I Am Coming Home (In Loving Memory)
djTiddy — Prezioso & Marvin - The Riddle remix [extended]
AllTime EDM — Jay Cosmic & Delora - Have It All (Jake Guercia's Heaven's Trap Remix)
George Picu — DJ Geezy - Mincke
Gripen — Rich Edwards - Where I'll Be Waiting (VIP Mix) (feat. Cozi Zuehlsdorff)
Merseus — Steve Aoki - Back 2 U (William Black Remix)
Trap City — Maxime Honoré & Cubblepot - Give Me Ur Love Now
User 200472075 — Gwen Stefani - Baby Don't Lie (Brady Greenman Remix)
Sam Friedman — Calvin Harris & Disciples - How Deep Is Your Love (T - Mass & Ellusive Remix)
